    #######
    #     ##
#####  *   #
#      *   #
#     #.#  #
## ## # ####
 #    $@#
 #   ####
 #####

