#####  ####
#   ####  #
#         #
###  # #  ##
  # **     #
 ##$*+ ##  #
 #  #  #  ##
 #        #
 #######  #
       ####
