     ####
######  #
#       #
#      .#
#@ #######
##       #
 # # #   #
 #     $ #
 #   #####
 #####
