#####  ####  #####
#   ####  ####   #
#                #
##        ###   ##
 ## $  # .. $ @##
##  ##   ####   ##
#                #
#   ##########   #
#####        #####
