#######
#     #
#  $$ #
# $ $@#
#..####
#..#   
####   