################ 
#       #@ #   # 
# # # # # $  $$# 
# #...# #$$$   # 
#  ...# # $  $$##
# ##.## # ##    #
# #...     $    #
# ## ###  #######
#    # ####      
######           