  #####
  #.  #
###   #
# $*$ #
#   ###
#@ .#  
#####  