#####  
#   ###
#..$$.#
# $$@ #
##  .##
 ##### 