#######
#     #
# +$# #
# **  #
# *   #
#######