#######
#     #
#     #
#  #  #
#$$$$$#
#..+..#
#######