#### 
# @# 
# $##
# $.#
# $.#
# $.#
###.#
  ###